# Maps are made up of layers.
# x means full block.
# - means half-block.
# o means no block.
#
 3 3 3 2 2 2 2 2 2 2 1 1 1 1 1 1 1
 3 3 3 3 2 2 2 2 2 2 2 1 1 1 1 1 1
 3 3 3 3 3 2 2 2 2 2 2 2 2 1 1 1 1
 3 3 3 3 3 2 2 2 2 2 2 2 2 2 1 1 1
 3 3 3 3 3 3 2 2 2 2 2 2 2 2 1 1 1
 3 3 3 3 3 3 2 2 2 2 2 2 2 2 2 1 1
 3 3 3 3 3 3 2 2 2 2 2 2 2 2 2 1 1
 3 3 3 3 3 3 2 2 2 2 2 2 2 2 2 2 1
 3 3 3 3 3 2 2 2 2 2 2 2 2 2 2 2 1
 3 3 3 3 3 2 2 2 2 2 2 2 2 2 2 2 2
 3 3 3 3 3 2 2 2 6 6 2 2 2 2 2 2 2
 3 3 3 3 2 2 2 2 6 6 2 2 2 2 2 2 2
 3 3 3 3 2 2 2 2 2 2 2 2 2 2 2 2 2
 3 3 3 2 2 2 2 2 2 2 2 2 2 2 2 2 2
 3 2 2 2 2 2 2 2 2 2 2 2 2 2 2 2 2
 2 2 2 2 2 2 2 2 2 2 2 2 2 2 2 2 2
 2 2 2 2 2 2 2 2 2 2 2 2 2 2 2 2 2
